1111111111111111111111111111111111111111111111111111111111111111
1200000000000000000000000000000000000000000000000000000000000001
1000000000000000000000000000000000000000000000000000000000000001
1000000000000000000000000000000000000000000000000000000000000001
1000000000000040000000000000000000000000000000000000000000000001
1000000000000040000000000000000000000000000000000000000000000001
1000000000000040000000000000000000000000000000000000000000000001
1000000000000040000000000000000000000000000000000000000000000001
1000000000000040000000000000000000000000000000000000000000000001
1000000000000040000000000000000000000000000000000000000000000001
1000000000000040000000000000000000000000000000000000000000000001
1000000000000040000000000000000000000000000000000000000000000001
1000000000000040000000000000000000000000000000000000000000000001
1000000000000040000000000000000000000000000000000000000000000001
1000000000000040000000000000000000000000000000000000000000000001
1000000000000040000000000000000000000000000000000000000000000001
1000000000000040000000000000000000000000000000000000000000000001
1000000000000040000000000000000000000000000000000000000000000001
1000000000000040000000000000000000000000000000000000000000000001
1000000000000040000000000000000000000000000000000000000030000001
1000000000000040000000000000000000000000000000000000111110000001
1000000000000040000000000000000000000000000000000000000000000001
1000000000000040000000000000000000000000000000000000000000000001
1000000000000000000000000000000000011000000000000000000000000001
1000000000000000000000000000000000040000000000000000000000000001
1000000000000000000000000000000000000000000000000000000000000001
1000000000000000111100000000000000000000000000000000000000000001
1000000000000000000000000000000000000000000000000000000000000001
1000000000000000000000000000000000000000000000000000000000000001
1002000000000004400000000000000000000000000000000000000000000001
1111111111111111111111111111111111111111111111111111111111111111